ASCII=American Standard Code for Information Interchange
BSD=Berkeley System Distribution
CGI=Common Gateway Interface
CLI=Command Line Interface
CVS=Concurrent Versioning System
DSL=Domain Specific Language
DVS=Decentralized Versioning System
ELF=Executable and Linking Format
FIFO=First In, First Out
FSI=Filesystem Integration
GNOME=GNU Network Object Model Environment
GPL=GNU General Public License
GPRS=General Packet Radio Service
GSM=Global System for Mobile Communications
GUI=Graphical User Interface
IMD[Bb]=Internet Movie Database
IRC=Internet Relay Chat
ISO=International Organization for Standardization; also short for a image of an ISO9660 (CD-ROM) file system
KDE=K-Desktop Environment; Kolorful Diskfilling Environment
KISS=Keep it simple, stupid
LIFO=Last In, First Out
NSFW=Not Safe For Work
OOP=Object-Oriented Programming
OSI=Open Source Initiative; Open Systems Interconnection
OSS=Open Source Software
QEMU=Quick EMUlator
SMTP=Simple Mail Transfer Protocol
SQL=Structured Query Language
UI=User Interface
UMTS=Universal Mobile Telecommunications System
URI=Uniform Resource Indicator
VM=Virtual Machine
WSGI=Web Server Gateway Interface
WYSIWYG=What you see is what you get
XMPP=Extensible Messaging and Presence Protocol 
YAML=Yet Another Markup Language
